11111111111111111111111111111111
10000001000000000000000000000001
10000001000000000000000000000001
10000001000000000000000000000001
10000001000000000000000000000001
10000001000000000000000000000001
10000000000000000000000000000001
11111100000000000000000000000001
10000000000000000000000000000001
10000000000000000000000000000001
10000000000000000000000000000001
10000000000000000000000000000001
10000000011111000000000000000001
10000000011111000000000000000001
10000000011111000000000000000001
10000000011111000000000000000001
10000000011111000000000000000001
10000000000000000000000000000001
10000000000000000000000000000001
10000000000000000000000000000001
10000000000000000000000000000001
10000000000000000000000000000001
10000000000000000000000000000001
10000000000000000000000000000001
10000000000000000000000000000001
10000000000000000000000000000001
10000000000000000000000000000001
10000000000000000000000000000001
10000000000000000000000000000001
10000000000000000000000000000001
10000000000000000000000000000001
11111111111111111111111111111111
